18 18 18 18 18 18 18 18 18 18 18 18 18 18 18 18 18 18 18 18 18 18 18 18 18 18 18 18 18 18 18 18 16 18 18 18 18 18 18 18 18 18 18 18 18 18 18 18 18 18 18 18 18 18 18 18 18 18 18 18
            18 18 18 18 18 18 18 18 18 18 18 18 16 18 18 18 18 18 18 18 18 18 18 18 18 18 18 18 18 18 18 18 18 18 18 18 18 18 18 18 18 18 18 18 18 18 18 18 18 18 18 18 18 16 18 18 18 18 18 18
            18 18 18 18 18 18 18 18 18 18 18 18 18 18 18 18 18 18 18 16 18 18 18 18 18 18 18 18 18 18 18 18 18 18 18 18 18 18 18 18 18 18 18 18 18 18 18 18 18 18 18 18 18 18 18 18 18 18 18 18
            18 18 18 16 18 18 18 18 18 18 18 18 18 18 18 18 18 18 18 18 18 18 18 18 18 18 16 18 18 18 18 18 18 18 18 18 18 16 18 18 18 18 18 18 18 18 18 16 18 18 18 18 18 18 18 18 18 18 18 18
            18 18 18 18 18 18 18 18 18 18 18 18 18 18 18 18 18 18 18 18 18 18 18 18 18 18 18 18 18 18 18 18 18 18 18 18 18 18 18 18 18 18 18 18 18 18 18 18 18 18 18 18 18 18 16 18 18 18 18 18
            18 18 18 18 18 18 18 18 18 18 18 18 18 18 18 18 18 18 18 18 18 18 18 18 18 18 18 18 18 18 18 18 18 18 18 18 18 18 18 18 18 18 18 18 18 18 18 18 18 18 18 18 18 18 18 18 18 18 18 18
            18 18 18 18 18 18 18 18 18 18 18 18 18 18 18 16 18 18 18 18 18 18 18 18 18 18 18 18 27 27 27 27 18 18 18 18 18 18 18 18 18 18 18 18 18 18 18 18 18 18 18 18 18 18 18 18 18 18 18 35
            18 18 18 18 18 16 18 18 18 18 18 18 18 18 18 18 18 18 18 18 18 18 18 18 18 18 27 27 27 27 27 27 27 27 18 18 18 18 18 18 18 18 18 18 18 18 18 18 18 18 18 18 18 16 18 18 18 18 35 34
            18 18 18 18 18 18 18 18 18 18 18 18 18 18 18 18 18 18 18 18 18 18 18 18 18 27 27 27 27 27 27 27 35 35 27 18 18 18 18 16 18 18 18 18 18 16 18 18 18 18 18 18 18 18 18 18 18 35 34 34
            18 18 18 18 18 18 18 18 18 18 18 16 18 18 18 18 18 18 18 18 16 18 18 18 27 27 27 27 27 27 27 27 35 35 27 27 18 18 18 18 18 18 18 18 18 18 18 18 18 18 18 18 18 18 18 18 35 35 34 62
            18 18 18 18 18 18 18 18 18 18 18 18 18 18 18 18 18 18 18 18 18 18 18 18 27 27 27 27 27 27 27 27 27 27 27 27 18 18 18 18 18 18 18 18 18 18 18 18 18 18 18 18 18 18 18 35 34 34 62 62
            18 18 18 18 18 18 18 18 18 18 18 18 18 18 18 18 18 18 18 18 18 18 18 34 27 27 27 35 35 27 27 27 27 27 27 27 27 18 18 18 18 18 18 18 18 18 18 18 18 18 18 18 18 35 35 34 34 34 62 62
            18 18 18 18 18 18 18 18 18 18 18 18 18 18 18 18 18 18 18 18 18 18 18 34 27 27 27 35 35 27 27 27 27 35 35 27 27 18 18 18 18 18 18 18 18 18 18 18 18 18 18 18 35 34 34 62 62 62 62 62
            18 18 18 18 18 18 18 18 18 18 18 18 18 18 18 18 18 18 18 18 18 18 18 34 34 27 27 27 27 27 27 27 27 35 35 27 27 18 18 18 16 18 18 18 18 18 18 18 18 18 18 35 34 62 62 62 62 62 62 62
            18 18 18 18 18 16 18 18 18 18 18 18 18 18 18 18 18 18 18 18 18 18 18 34 34 27 27 27 27 27 27 27 27 27 27 27 27 18 18 18 18 18 18 18 18 18 18 18 18 18 35 34 62 62 62 62 62 62 62 62
            18 18 18 18 18 18 18 18 18 18 18 18 18 18 16 18 18 18 18 18 18 18 18 18 34 27 27 27 27 27 27 27 27 27 27 27 18 18 18 18 18 18 18 18 18 18 18 18 35 35 34 62 62 62 62 62 62 62 62 62
            18 18 18 18 18 18 18 18 18 18 18 18 18 18 18 18 18 18 18 18 18 18 18 18 34 34 34 27 27 27 27 27 27 27 27 27 18 18 18 18 18 18 18 18 18 18 18 35 34 34 62 62 62 62 62 62 62 62 62 62
            18 18 18 18 18 18 18 18 18 18 18 18 18 18 18 18 18 18 18 18 18 18 18 18 18 34 34 34 27 27 27 27 27 27 27 18 18 18 18 18 18 18 18 18 18 18 35 35 34 62 62 62 62 62 62 62 62 62 62 62
            18 18 18 18 18 18 18 18 18 18 18 18 18 18 18 18 18 18 18 18 18 18 18 18 18 18 34 34 34 34 27 27 27 27 18 18 18 18 18 18 18 18 18 18 18 35 34 34 62 62 62 62 62 62 62 62 62 62 62 62
            18 18 18 18 16 18 18 18 18 18 18 16 18 18 18 18 16 18 18 18 18 18 18 18 18 18 18 18 34 34 34 27 18 18 18 18 18 18 18 18 18 18 18 18 35 34 62 62 62 62 62 62 62 62 62 62 62 62 62 62
            18 18 18 18 18 18 18 18 18 18 18 18 18 18 18 18 18 18 18 18 18 18 18 18 18 18 18 18 18 18 18 18 18 18 18 18 18 18 18 18 18 18 35 35 34 62 62 62 62 62 62 62 62 62 62 62 62 62 62 62
            18 18 18 18 18 18 18 18 18 18 18 18 18 18 18 18 18 18 18 18 18 18 18 18 18 18 18 18 18 18 18 18 18 18 18 18 18 18 18 18 18 35 34 34 62 62 62 62 62 62 62 62 62 62 62 62 62 62 62 62
            18 18 18 18 18 18 18 18 18 18 18 18 18 18 18 18 18 18 18 18 18 18 18 18 18 18 18 18 18 18 18 18 18 18 18 18 18 18 18 18 35 34 62 62 62 62 62 62 62 62 62 62 62 62 62 62 62 62 62 62
            18 18 18 18 18 18 18 18 18 18 18 18 18 18 18 18 18 18 18 18 18 18 18 18 18 18 18 18 18 18 18 18 18 18 18 18 18 18 18 35 34 62 62 62 62 62 62 62 62 62 62 62 62 62 62 62 62 62 62 62
            18 18 18 18 18 18 18 18 18 18 18 18 18 18 18 18 18 18 18 18 18 18 18 18 18 18 18 18 18 18 18 18 18 18 18 18 18 18 35 34 62 62 62 62 62 62 62 62 62 62 62 62 62 62 62 62 62 62 62 62
            18 18 18 18 18 18 18 18 18 18 18 18 18 18 18 18 18 18 18 18 18 18 18 18 18 18 18 18 18 18 18 18 18 18 18 18 18 35 34 62 62 62 62 62 62 62 62 62 62 62 62 62 62 62 62 62 62 62 62 62
            18 18 18 18 18 18 18 18 18 18 18 18 18 18 18 18 18 18 18 18 18 18 18 18 18 18 18 18 18 18 18 18 18 18 18 18 18 18 18 18 18 18 18 18 18 18 18 18 18 18 18 18 18 18 18 18 18 18 18 18
            18 18 18 18 18 18 18 18 18 18 18 18 18 18 18 18 18 18 18 18 18 18 18 18 18 18 18 18 18 18 18 18 18 18 18 18 18 18 18 18 18 18 18 18 18 18 18 18 18 18 18 18 18 18 18 18 18 18 18 18
            18 18 18 18 18 18 18 18 18 18 18 18 18 18 18 18 18 18 18 18 18 18 18 18 18 18 18 18 18 18 18 18 18 18 18 18 18 18 18 18 18 18 18 18 18 18 18 18 18 18 18 18 18 18 18 18 18 18 18 18
            18 18 18 18 18 18 18 18 18 18 18 18 18 18 18 18 18 18 18 18 18 18 18 18 18 18 18 18 18 18 18 18 18 18 18 18 18 18 18 18 18 18 18 18 18 18 18 18 18 18 18 18 18 18 18 18 18 18 18 18
            18 18 18 18 18 18 18 18 18 18 18 18 18 18 18 18 18 18 18 18 18 18 18 18 18 18 18 18 18 18 18 18 18 18 18 18 18 18 18 18 18 18 18 18 18 18 18 18 18 18 18 18 18 18 18 18 18 18 18 18